1111111111111
1011001100001
1101100101001
1000011010001
1000010000001
1100010000001
1000010000001
1011001001001
1100001000001
1001001101001
1000000000101
1000000010111
1111111111111
